


11111
1000N1
11111

NO ./textures/wall_north.xpm
SO ./textures/wall_south.xpm
WE ./textures/wall_west.xpm
EA ./textures/wall_east.xpm      



F 220,100,0
C 225,30,0





