NO ./textures/wall_north.xpm
SO ./textures/wall_south.xpm
WE ./textures/wall_west.xpm
EA ./textures/wall_east.xpm                                                     

F 220,100,                              50
C 220,30,50

        1111111111111111111111111
        1000000000110001000000001
        101100000111001 1000000001
        1001000000040001000000001
111111111011000001110000000003331
133333110000011101111141111111111
11110111111111011100000010301
11000000110101011100000010001
11110111111111011133333313331
11110111111111000001010010001
11000000110101011100000010001
11110111111111011100000010301
11110111111111000001010010001
11000000110101011100000010001
13333333333333331100000010301
10000000000000001101011111411
110000011101010111110003400001
11110111 1110101 101111011N001
11111111 1111111 1111111111111
